日期,确诊人数总数,新增确诊人数,治愈人数总数,新增治愈人数,现在确诊人数,现在新增确诊人数,死亡人数,新增死亡人数,高风险地区,中风险地区,疑似人数,新增疑似人数
20200122,1,1,0,0,0,1,0,0,0,0,0,0
20200123,9,8,0,0,0,9,0,0,0,0,0,0
20200124,18,9,1,1,1,17,0,0,0,0,0,0
20200125,31,13,1,0,1,30,0,0,0,0,0,0
20200126,47,16,1,0,1,46,0,0,0,0,0,0
20200127,70,23,1,0,1,69,0,0,0,0,0,0
20200128,99,29,1,0,1,98,0,0,0,0,0,0
20200129,129,30,1,0,1,128,0,0,0,0,0,0
20200130,168,39,2,1,2,166,0,0,0,0,0,0
20200131,202,34,5,3,5,197,0,0,0,0,0,0
20200201,236,34,6,1,6,230,0,0,0,0,0,0
20200202,271,35,7,1,7,264,0,0,0,0,0,0
20200203,308,37,8,1,8,300,0,0,0,0,0,0
20200204,341,33,13,5,13,328,0,0,0,0,0,0
20200205,373,32,26,13,26,347,0,0,0,0,0,0
20200206,408,35,38,12,38,370,0,0,0,0,0,0
20200207,439,31,43,5,43,396,0,0,0,0,0,0
20200208,468,29,51,8,51,417,0,0,0,0,0,0
20200209,492,24,72,21,72,420,0,0,0,0,0,0
20200210,515,23,84,12,84,431,0,0,0,0,0,0
20200211,543,28,94,10,94,449,0,0,0,0,0,0
20200212,570,27,131,37,131,439,0,0,0,0,0,0
20200213,593,23,137,6,137,456,0,0,0,0,0,0
20200214,604,11,160,23,160,444,0,0,0,0,0,0
20200215,617,13,190,30,190,427,0,0,0,0,0,0
20200216,626,9,226,36,226,400,0,0,0,0,0,0
20200217,629,3,263,37,263,366,0,0,0,0,0,0
20200218,631,2,296,33,296,335,0,0,0,0,0,0
20200219,631,0,325,29,325,306,0,0,0,0,0,0
20200220,631,0,352,27,352,279,0,0,0,0,0,0
20200221,631,0,387,35,387,244,0,0,0,0,0,0
20200222,631,0,411,24,411,220,0,0,0,0,0,0
20200223,631,0,427,16,427,204,0,0,0,0,0,0
20200224,631,0,458,31,458,173,0,0,0,0,0,0
20200225,631,0,463,5,463,168,0,0,0,0,0,0
20200226,631,0,494,31,494,137,0,0,0,0,0,0
20200227,631,0,506,12,506,125,0,0,0,0,0,0
20200228,631,0,519,13,519,112,0,0,0,0,0,0
20200229,631,0,529,10,529,102,0,0,0,0,0,0
20200301,631,0,536,7,536,95,0,0,0,0,0,0
20200302,631,0,555,19,555,76,0,0,0,0,0,0
20200303,631,0,565,10,565,66,0,0,0,0,0,0
20200304,631,0,580,15,580,51,0,0,0,0,0,0
20200305,631,0,588,8,588,43,0,0,0,0,0,0
20200306,631,0,601,13,601,30,0,0,0,0,0,0
20200307,631,0,610,9,610,21,0,0,0,0,0,0
20200308,631,0,618,8,618,13,0,0,0,0,0,0
20200309,631,0,622,4,622,9,0,0,0,0,0,0
20200310,631,0,627,5,627,4,0,0,0,0,0,0
20200311,631,0,628,1,628,3,0,0,0,0,0,0
20200312,631,0,630,2,630,1,0,0,0,0,0,0
20200313,631,0,630,0,630,1,0,0,0,0,0,0
20200314,631,0,631,1,631,0,0,0,0,0,0,0
20200315,631,0,631,0,631,0,0,0,0,0,0,0
20200316,631,0,631,0,631,0,0,0,0,0,0,0
20200317,631,0,631,0,631,0,0,0,0,0,0,0
20200318,631,0,631,0,631,0,0,0,0,0,0,0
20200319,631,0,631,0,631,0,0,0,0,0,0,0
20200320,631,0,631,0,631,0,0,0,0,0,0,0
20200321,633,2,631,0,631,2,0,0,0,0,0,0
20200322,633,0,631,0,631,2,0,0,0,0,0,0
20200323,636,3,631,0,631,5,0,0,0,0,0,0
20200324,638,2,631,0,631,7,0,0,0,0,0,0
20200325,640,2,631,0,631,9,0,0,0,0,0,0
20200326,641,1,631,0,631,10,0,0,0,0,0,0
20200327,641,0,631,0,631,10,0,0,0,0,0,0
20200328,644,3,631,0,631,13,0,0,0,0,3,3
20200329,645,1,631,0,631,14,0,0,0,0,3,0
20200330,646,1,631,0,631,15,0,0,0,0,3,0
20200331,646,0,631,0,631,15,0,0,0,0,3,0
20200401,647,1,631,0,631,16,0,0,0,0,3,0
20200402,651,4,632,1,632,19,0,0,0,0,0,-3
20200403,651,0,632,0,632,19,0,0,0,0,0,0
20200404,651,0,633,1,633,18,0,0,0,0,3,3
20200405,651,0,633,0,633,18,0,0,0,0,3,0
20200406,651,0,633,0,633,18,0,0,0,0,3,0
20200407,651,0,633,0,633,18,0,0,0,0,0,-3
20200408,651,0,633,0,633,18,0,0,0,0,0,0
20200409,651,0,634,1,634,17,0,0,0,0,3,3
20200410,652,1,636,2,636,16,0,0,0,0,3,0
20200411,653,1,638,2,638,15,0,0,0,0,3,0
20200412,653,0,638,0,638,15,0,0,0,0,3,0
20200413,653,0,641,3,641,12,0,0,0,0,3,0
20200414,653,0,642,1,642,11,0,0,0,0,3,0
20200415,653,0,642,0,642,11,0,0,0,0,3,0
20200416,653,0,643,1,643,10,0,0,0,0,3,0
20200417,653,0,643,0,643,10,0,0,0,0,3,0
20200418,653,0,643,0,643,10,0,0,0,0,3,0
20200419,653,0,643,0,643,10,0,0,0,0,3,0
20200420,653,0,644,1,644,9,0,0,0,0,3,0
20200421,653,0,645,1,645,8,0,0,0,0,3,0
20200422,653,0,645,0,645,8,0,0,0,0,3,0
20200423,653,0,646,1,646,7,0,0,0,0,3,0
20200424,653,0,646,0,646,7,0,0,0,0,3,0
20200425,653,0,646,0,646,7,0,0,0,0,3,0
20200426,653,0,646,0,646,7,0,0,0,0,3,0
20200427,653,0,646,0,646,7,0,0,0,0,3,0
20200428,653,0,647,1,647,6,0,0,0,0,3,0
20200429,653,0,648,1,648,5,0,0,0,0,3,0
20200430,653,0,650,2,650,3,0,0,0,0,3,0
20200501,653,0,650,0,650,3,0,0,0,0,3,0
20200502,653,0,650,0,650,3,0,0,0,0,3,0
20200503,653,0,650,0,650,3,0,0,0,0,3,0
20200504,653,0,650,0,650,3,0,0,0,0,3,0
20200505,653,0,650,0,650,3,0,0,0,0,3,0
20200506,653,0,651,1,651,2,0,0,0,0,3,0
20200507,653,0,652,1,652,1,0,0,0,0,3,0
20200508,653,0,652,0,652,1,0,0,0,0,3,0
20200509,653,0,652,0,652,1,0,0,0,0,3,0
20200510,653,0,653,1,653,0,0,0,0,0,3,0
20200511,653,0,653,0,653,0,0,0,0,0,3,0
20200512,653,0,653,0,653,0,0,0,0,0,3,0
20200513,653,0,653,0,653,0,0,0,0,0,3,0
20200514,653,0,653,0,653,0,0,0,0,0,3,0
20200515,653,0,653,0,653,0,0,0,0,0,3,0
20200516,653,0,653,0,653,0,0,0,0,0,3,0
20200517,653,0,653,0,653,0,0,0,0,0,3,0
20200518,653,0,653,0,653,0,0,0,0,0,3,0
20200519,653,0,653,0,653,0,0,0,0,0,3,0
20200520,653,0,653,0,653,0,0,0,0,0,3,0
20200521,653,0,653,0,653,0,0,0,0,0,3,0
20200522,653,0,653,0,653,0,0,0,0,0,3,0
20200523,653,0,653,0,653,0,0,0,0,0,3,0
20200524,653,0,653,0,653,0,0,0,0,0,3,0
20200525,653,0,653,0,653,0,0,0,0,0,3,0
20200526,653,0,653,0,653,0,0,0,0,0,3,0
20200527,653,0,653,0,653,0,0,0,0,0,3,0
20200528,653,0,653,0,653,0,0,0,0,0,3,0
20200529,653,0,653,0,653,0,0,0,0,0,3,0
20200530,653,0,653,0,653,0,0,0,0,0,3,0
20200531,653,0,653,0,653,0,0,0,0,0,3,0
20200601,653,0,653,0,653,0,0,0,0,0,3,0
20200602,653,0,653,0,653,0,0,0,0,0,3,0
20200603,653,0,653,0,653,0,0,0,0,0,3,0
20200604,653,0,653,0,653,0,0,0,0,0,3,0
20200605,653,0,653,0,653,0,0,0,0,0,3,0
20200606,653,0,653,0,653,0,0,0,0,0,3,0
20200607,653,0,653,0,653,0,0,0,0,0,3,0
20200608,653,0,653,0,653,0,0,0,0,0,3,0
20200609,653,0,653,0,653,0,0,0,0,0,3,0
20200610,653,0,653,0,653,0,0,0,0,0,3,0
20200611,653,0,653,0,653,0,0,0,0,0,3,0
20200612,653,0,653,0,653,0,0,0,0,0,3,0
20200613,653,0,653,0,653,0,0,0,0,0,3,0
20200614,653,0,653,0,653,0,0,0,0,0,3,0
20200615,653,0,653,0,653,0,0,0,0,0,3,0
20200616,653,0,653,0,653,0,0,0,0,0,3,0
20200617,653,0,653,0,653,0,0,0,0,0,3,0
20200618,653,0,653,0,653,0,0,0,0,0,3,0
20200619,653,0,653,0,653,0,0,0,0,0,3,0
20200620,653,0,653,0,653,0,0,0,0,0,3,0
20200621,653,0,653,0,653,0,0,0,0,0,3,0
20200622,654,1,653,0,653,1,0,0,0,0,3,0
20200623,654,0,653,0,653,1,0,0,0,0,3,0
20200624,654,0,653,0,653,1,0,0,0,0,3,0
20200625,654,0,653,0,653,1,0,0,0,0,3,0
20200626,654,0,653,0,653,1,0,0,0,0,3,0
20200627,654,0,653,0,653,1,0,0,0,0,3,0
20200628,654,0,653,0,653,1,0,0,0,0,3,0
20200629,654,0,653,0,653,1,0,0,0,0,3,0
20200630,654,0,654,1,654,0,0,0,0,0,3,0
20200701,654,0,653,-1,653,1,0,0,0,0,3,0
20200702,654,0,653,0,653,1,0,0,0,0,3,0
20200703,654,0,653,0,653,1,0,0,0,0,3,0
20200704,654,0,653,0,653,1,0,0,0,0,3,0
20200705,654,0,653,0,653,1,0,0,0,0,3,0
20200706,654,0,653,0,653,1,0,0,0,0,3,0
20200707,654,0,654,1,654,0,0,0,0,0,3,0
20200708,654,0,654,0,654,0,0,0,0,0,3,0
20200709,654,0,654,0,654,0,0,0,0,0,3,0
20200710,654,0,654,0,654,0,0,0,0,0,3,0
20200711,654,0,654,0,654,0,0,0,0,0,3,0
20200712,654,0,654,0,654,0,0,0,0,0,3,0
20200713,654,0,654,0,654,0,0,0,0,0,3,0
20200714,654,0,654,0,654,0,0,0,0,0,3,0
20200715,654,0,654,0,654,0,0,0,0,0,3,0
20200716,655,1,654,0,654,1,0,0,0,0,3,0
20200717,655,0,654,0,654,1,0,0,0,0,3,0
20200718,655,0,654,0,654,1,0,0,0,0,3,0
20200719,655,0,654,0,654,1,0,0,0,0,3,0
20200720,655,0,654,0,654,1,0,0,0,0,3,0
20200722,655,0,654,0,654,1,0,0,0,0,3,0
20200724,655,0,654,0,654,1,0,0,0,0,3,0
20200725,655,0,654,0,654,1,0,0,0,0,3,0
20200726,655,0,654,0,654,1,0,0,0,0,3,0
20200727,655,0,654,0,654,1,0,0,0,0,3,0
20200728,655,0,654,0,654,1,0,0,0,0,3,0
20200729,655,0,654,0,654,1,0,0,0,0,3,0
20200730,655,0,654,0,654,1,0,0,0,0,3,0
20200731,655,0,654,0,654,1,0,0,0,0,3,0
20200801,655,0,654,0,654,1,0,0,0,0,3,0
20200802,658,3,654,0,654,4,0,0,0,0,3,0
20200803,658,0,654,0,654,4,0,0,0,0,3,0
20200804,658,0,654,0,654,4,0,0,0,0,3,0
20200806,659,1,654,0,654,5,0,0,0,0,3,0
20200807,659,0,654,0,654,5,0,0,0,0,3,0
20200808,659,0,654,0,654,5,0,0,0,0,3,0
20200809,659,0,654,0,654,5,0,0,0,0,3,0
20200810,659,0,655,1,655,4,0,0,0,0,3,0
20200812,659,0,656,1,656,3,0,0,0,0,3,0
20200813,659,0,656,0,656,3,0,0,0,0,3,0
20200814,661,2,655,-1,655,6,0,0,0,0,3,0
20200815,661,0,655,0,655,6,0,0,0,0,3,0
20200816,661,0,655,0,655,6,0,0,0,0,3,0
20200817,664,3,655,0,655,9,0,0,0,0,3,0
20200818,664,0,655,0,655,9,0,0,0,0,3,0
20200820,665,1,656,1,656,9,0,0,0,0,3,0
20200821,665,0,656,0,656,9,0,0,0,0,3,0
20200822,665,0,656,0,656,9,0,0,0,0,3,0
20200823,665,0,656,0,656,9,0,0,0,0,3,0
20200824,665,0,656,0,656,9,0,0,0,0,3,0
20200825,665,0,656,0,656,9,0,0,0,0,3,0
20200826,665,0,657,1,657,8,0,0,0,0,3,0
20200827,665,0,657,0,657,8,0,0,0,0,3,0
20200828,665,0,657,0,657,8,0,0,0,0,3,0
20200829,665,0,657,0,657,8,0,0,0,0,3,0
20200830,665,0,657,0,657,8,0,0,0,0,3,0
20200831,665,0,658,1,658,7,0,0,0,0,3,0
20200901,665,0,659,1,659,6,0,0,0,0,3,0
20200902,665,0,659,0,659,6,0,0,0,0,3,0
20200903,665,0,659,0,659,6,0,0,0,0,3,0
20200904,665,0,661,2,661,4,0,0,0,0,3,0
20200905,665,0,661,0,661,4,0,0,0,0,3,0
20200906,665,0,661,0,661,4,0,0,0,0,3,0
20200907,665,0,661,0,661,4,0,0,0,0,3,0
20200909,665,0,661,0,661,4,0,0,0,0,3,0
20200910,665,0,663,2,663,2,0,0,0,0,3,0
20200911,665,0,663,0,663,2,0,0,0,0,3,0
20200913,665,0,663,0,663,2,0,0,0,0,3,0
20200914,665,0,663,0,663,2,0,0,0,0,3,0
20200915,665,0,663,0,663,2,0,0,0,0,3,0
20200919,665,0,664,1,664,1,0,0,0,0,3,0
20200920,665,0,664,0,664,1,0,0,0,0,3,0
20200921,665,0,664,0,664,1,0,0,0,0,3,0
20200922,665,0,664,0,664,1,0,0,0,0,3,0
20200923,666,1,664,0,664,2,0,0,0,0,3,0
20200924,666,0,664,0,664,2,0,0,0,0,3,0
20200925,666,0,664,0,664,2,0,0,0,0,3,0
20200926,666,0,664,0,664,2,0,0,0,0,3,0
20200927,666,0,664,0,664,2,0,0,0,0,3,0
20200928,666,0,664,0,664,2,0,0,0,0,3,0
20200929,666,0,664,0,664,2,0,0,0,0,3,0
20201001,666,0,664,0,664,2,0,0,0,0,3,0
20201002,666,0,664,0,664,2,0,0,0,0,3,0
20201003,666,0,664,0,664,2,0,0,0,0,3,0
20201004,667,1,664,0,664,3,0,0,0,0,3,0
20201005,667,0,664,0,664,3,0,0,0,0,3,0
20201006,667,0,664,0,664,3,0,0,0,0,3,0
20201007,667,0,664,0,664,3,0,0,0,0,3,0
20201008,667,0,664,0,664,3,0,0,0,0,3,0
20201009,667,0,664,0,664,3,0,0,0,0,3,0
20201010,667,0,664,0,664,3,0,0,0,0,3,0
20201011,667,0,664,0,664,3,0,0,0,0,3,0
20201012,667,0,664,0,664,3,0,0,0,0,3,0
20201013,667,0,664,0,664,3,0,0,0,0,3,0
20201014,667,0,664,0,664,3,0,0,0,0,3,0
20201015,669,2,664,0,664,5,0,0,0,0,3,0
20201016,669,0,665,1,665,4,0,0,0,0,3,0
20201017,669,0,665,0,665,4,0,0,0,0,3,0
20201018,669,0,665,0,665,4,0,0,0,0,3,0
20201019,670,1,665,0,665,5,0,0,0,0,3,0
20201020,670,0,665,0,665,5,0,0,0,0,3,0
20201021,670,0,665,0,665,5,0,0,0,0,3,0
20201022,670,0,665,0,665,5,0,0,0,0,3,0
20201023,670,0,665,0,665,5,0,0,0,0,3,0
20201024,670,0,665,0,665,5,0,0,0,0,3,0
20201025,670,0,665,0,665,5,0,0,0,0,3,0
20201026,670,0,666,1,666,4,0,0,0,0,3,0
20201027,670,0,666,0,666,4,0,0,0,0,3,0
20201028,672,2,666,0,666,6,0,0,0,0,3,0
20201030,672,0,666,0,666,6,0,0,0,0,3,0
20201031,672,0,666,0,666,6,0,0,0,0,3,0
20201101,673,1,666,0,666,7,0,0,0,0,3,0
20201102,674,1,666,0,666,8,0,0,0,0,3,0
20201103,674,0,666,0,666,8,0,0,0,0,3,0
20201104,674,0,666,0,666,8,0,0,0,0,3,0
20201105,674,0,666,0,666,8,0,0,0,0,3,0
20201106,674,0,666,0,666,8,0,0,0,0,3,0
20201108,675,1,666,0,666,9,0,0,0,0,3,0
20201109,675,0,666,0,666,9,0,0,0,0,3,0
20201110,676,1,666,0,666,10,0,0,0,0,3,0
20201111,676,0,666,0,666,10,0,0,0,0,3,0
20201112,676,0,666,0,666,10,0,0,0,0,3,0
20201114,676,0,666,0,666,10,0,0,0,0,3,0
20201115,677,1,666,0,666,11,0,0,0,0,3,0
20201117,677,0,668,2,668,9,0,0,0,0,3,0
20201118,677,0,668,0,668,9,0,0,0,0,3,0
20201119,677,0,668,0,668,9,0,0,0,0,3,0
20201120,677,0,670,2,670,7,0,0,0,0,3,0
20201121,677,0,670,0,670,7,0,0,0,0,3,0
20201122,677,0,670,0,670,7,0,0,0,0,3,0
20201123,679,2,671,1,671,8,0,0,0,0,3,0
20201124,679,0,671,0,671,8,0,0,0,0,3,0
20201125,680,1,672,1,672,8,0,0,0,0,3,0
20201126,680,0,672,0,672,8,0,0,0,0,3,0
20201127,680,0,672,0,672,8,0,0,0,0,3,0
20201128,680,0,672,0,672,8,0,0,0,0,3,0
20201129,680,0,672,0,672,8,0,0,0,0,3,0
20201130,680,0,672,0,672,8,0,0,0,0,3,0
20201201,680,0,672,0,672,8,0,0,0,0,3,0
20201202,680,0,672,0,672,8,0,0,0,0,3,0
20201203,680,0,672,0,672,8,0,0,0,0,3,0
20201204,680,0,674,2,674,6,0,0,0,0,3,0
20201206,680,0,674,0,674,6,0,0,0,0,3,0
20201207,680,0,674,0,674,6,0,0,0,0,3,0
20201208,681,1,675,1,675,6,0,0,0,0,3,0
20201209,681,0,675,0,675,6,0,0,0,0,3,0
20201210,681,0,675,0,675,6,0,0,0,0,3,0
20201211,683,2,675,0,675,8,0,0,0,0,3,0
20201212,684,1,675,0,675,9,0,0,0,0,3,0
20201213,684,0,675,0,675,9,0,0,0,0,3,0
20201214,684,0,675,0,675,9,0,0,0,0,3,0
20201215,684,0,675,0,675,9,0,0,0,0,3,0
20201216,684,0,675,0,675,9,0,0,0,0,3,0
20201217,684,0,676,1,676,8,0,0,0,0,3,0
20201218,684,0,677,1,677,7,0,0,0,0,3,0
20201219,684,0,678,1,678,6,0,0,0,0,3,0
20201220,684,0,679,1,679,5,0,0,0,0,3,0
20201221,684,0,679,0,679,5,0,0,0,0,3,0
20201222,684,0,679,0,679,5,0,0,0,0,3,0
20201223,684,0,679,0,679,5,0,0,0,0,3,0
20201224,684,0,679,0,679,5,0,0,0,0,3,0
20201225,684,0,682,3,682,2,0,0,0,0,3,0
20201226,684,0,682,0,682,2,0,0,0,0,3,0
20201227,684,0,682,0,682,2,0,0,0,0,3,0
20201228,684,0,682,0,682,2,0,0,0,0,3,0
20201229,684,0,682,0,682,2,0,0,0,0,3,0
20201230,684,0,682,0,682,2,0,0,0,0,3,0
20201231,684,0,682,0,682,2,0,0,0,0,3,0
20210101,684,0,682,0,682,2,0,0,0,0,3,0
20210102,684,0,682,0,682,2,0,0,0,0,3,0
20210103,684,0,683,1,683,1,0,0,0,0,3,0
20210104,685,1,683,0,683,2,0,0,0,0,3,0
20210105,685,0,684,1,684,1,0,0,0,0,3,0
20210106,685,0,684,0,684,1,0,0,0,0,3,0
20210107,686,1,684,0,684,2,0,0,0,0,3,0
20210108,687,1,684,0,684,3,0,0,0,0,3,0
20210109,687,0,684,0,684,3,0,0,0,0,3,0
20210110,687,0,684,0,684,3,0,0,0,0,3,0
20210111,687,0,684,0,684,3,0,0,0,0,3,0
20210112,687,0,684,0,684,3,0,0,0,0,3,0
20210113,687,0,684,0,684,3,0,0,0,0,3,0
20210114,688,1,684,0,684,4,0,0,0,0,3,0
20210115,688,0,684,0,684,4,0,0,0,0,3,0
20210116,688,0,684,0,684,4,0,0,0,0,3,0
20210117,688,0,684,0,684,4,0,0,0,0,3,0
20210118,688,0,684,0,684,4,0,0,0,0,3,0
20210119,688,0,684,0,684,4,0,0,0,0,3,0
20210120,688,0,684,0,684,4,0,0,0,0,3,0
20210121,688,0,684,0,684,4,0,0,0,0,3,0
20210122,690,2,685,1,685,5,0,0,0,0,3,0
20210123,691,1,685,0,685,6,0,0,0,0,3,0
20210124,691,0,685,0,685,6,0,0,0,0,3,0
20210125,691,0,685,0,685,6,0,0,0,0,3,0
20210126,692,1,685,0,685,7,0,0,0,0,3,0
20210127,693,1,685,0,685,8,0,0,0,0,3,0
20210128,693,0,685,0,685,8,0,0,0,0,3,0
20210129,693,0,685,0,685,8,0,0,0,0,3,0
20210130,694,1,686,1,686,8,0,0,0,0,3,0
20210131,694,0,686,0,686,8,0,0,0,0,3,0
20210201,697,3,686,0,686,11,0,0,0,0,3,0
20210202,698,1,686,0,686,12,0,0,0,0,3,0
20210203,698,0,686,0,686,12,0,0,0,0,3,0
20210204,699,1,687,1,687,12,0,0,0,0,3,0
20210205,699,0,687,0,687,12,0,0,0,0,3,0
20210206,701,2,687,0,687,14,0,0,0,0,3,0
20210207,701,0,687,0,687,14,0,0,0,0,3,0
20210208,702,1,688,1,688,14,0,0,0,0,3,0
20210209,703,1,688,0,688,15,0,0,0,0,3,0
20210210,703,0,688,0,688,15,0,0,0,0,3,0
20210211,703,0,688,0,688,15,0,0,0,0,3,0
20210212,703,0,688,0,688,15,0,0,0,0,3,0
20210213,703,0,688,0,688,15,0,0,0,0,3,0
20210214,703,0,688,0,688,15,0,0,0,0,3,0
20210215,703,0,688,0,688,15,0,0,0,0,3,0
20210216,703,0,688,0,688,15,0,0,0,0,3,0
20210217,703,0,688,0,688,15,0,0,0,0,3,0
20210218,703,0,689,1,689,14,0,0,0,0,3,0
20210219,703,0,696,7,696,7,0,0,0,0,3,0
20210220,703,0,696,0,696,7,0,0,0,0,3,0
20210221,703,0,698,2,698,5,0,0,0,0,3,0
20210222,703,0,698,0,698,5,0,0,0,0,3,0
20210223,704,1,698,0,698,6,0,0,0,0,3,0
20210224,704,0,698,0,698,6,0,0,0,0,3,0
20210225,704,0,698,0,698,6,0,0,0,0,3,0
20210226,704,0,698,0,698,6,0,0,0,0,3,0
20210227,704,0,698,0,698,6,0,0,0,0,3,0
20210228,704,0,698,0,698,6,0,0,0,0,3,0
20210301,704,0,699,1,699,5,0,0,0,0,3,0
20210302,704,0,700,1,700,4,0,0,0,0,3,0
20210303,704,0,700,0,700,4,0,0,0,0,3,0
20210304,704,0,701,1,701,3,0,0,0,0,3,0
20210305,704,0,702,1,702,2,0,0,0,0,3,0
20210306,704,0,702,0,702,2,0,0,0,0,3,0
20210307,704,0,702,0,702,2,0,0,0,0,3,0
20210308,705,1,703,1,703,2,0,0,0,0,3,0
20210309,705,0,703,0,703,2,0,0,0,0,3,0
20210310,705,0,703,0,703,2,0,0,0,0,3,0
20210311,705,0,704,1,704,1,0,0,0,0,3,0
20210312,705,0,704,0,704,1,0,0,0,0,3,0
20210313,706,1,704,0,704,2,0,0,0,0,3,0
20210314,706,0,704,0,704,2,0,0,0,0,3,0
20210315,707,1,704,0,704,3,0,0,0,0,3,0
20210316,707,0,704,0,704,3,0,0,0,0,3,0
20210317,707,0,704,0,704,3,0,0,0,0,3,0
20210318,707,0,704,0,704,3,0,0,0,0,3,0
20210319,708,1,704,0,704,4,0,0,0,0,3,0
20210320,708,0,704,0,704,4,0,0,0,0,3,0
20210321,708,0,704,0,704,4,0,0,0,0,3,0
20210322,708,0,704,0,704,4,0,0,0,0,3,0
20210323,708,0,704,0,704,4,0,0,0,0,3,0
20210324,708,0,704,0,704,4,0,0,0,0,3,0
20210325,708,0,704,0,704,4,0,0,0,0,3,0
20210326,708,0,704,0,704,4,0,0,0,0,3,0
20210327,708,0,704,0,704,4,0,0,0,0,3,0
20210328,708,0,704,0,704,4,0,0,0,0,3,0
20210329,708,0,704,0,704,4,0,0,0,0,3,0
20210330,708,0,704,0,704,4,0,0,0,0,3,0
20210331,710,2,704,0,704,6,0,0,0,0,3,0
20210401,710,0,704,0,704,6,0,0,0,0,3,0
20210402,710,0,704,0,704,6,0,0,0,0,3,0
20210403,711,1,704,0,704,7,0,0,0,0,3,0
20210404,713,2,704,0,704,9,0,0,0,0,3,0
20210405,714,1,704,0,704,10,0,0,0,0,3,0
20210406,715,1,706,2,706,9,0,0,0,0,3,0
20210407,716,1,707,1,707,9,0,0,0,0,3,0
20210408,716,0,707,0,707,9,0,0,0,0,3,0
20210409,716,0,707,0,707,9,0,0,0,0,3,0
20210410,716,0,708,1,708,8,0,0,0,0,3,0
20210411,716,0,708,0,708,8,0,0,0,0,3,0
20210412,716,0,708,0,708,8,0,0,0,0,3,0
20210413,716,0,708,0,708,8,0,0,0,0,3,0
20210414,716,0,708,0,708,8,0,0,0,0,3,0
20210415,716,0,708,0,708,8,0,0,0,0,3,0
20210416,716,0,708,0,708,8,0,0,0,0,3,0
20210417,716,0,708,0,708,8,0,0,0,0,3,0
20210418,716,0,708,0,708,8,0,0,0,0,3,0
20210419,716,0,708,0,708,8,0,0,0,0,3,0
20210420,716,0,708,0,708,8,0,0,0,0,3,0
20210421,716,0,708,0,708,8,0,0,0,0,3,0
20210422,716,0,708,0,708,8,0,0,0,0,3,0
20210423,716,0,708,0,708,8,0,0,0,0,3,0
20210424,717,1,708,0,708,9,0,0,0,0,3,0
20210425,718,1,709,1,709,9,0,0,0,0,3,0
20210426,718,0,709,0,709,9,0,0,0,0,3,0
